11111111111111
1s000000000001
10000000000001
10000000000001
100000K0000001
10000000000001
10000000000001
10000000000LL1
100K0000000Lq1
11111111111111