1111111111111111
1s00000000000K01
1111111111L11111
1K000000000000011111111111111
1000111K0000000L0000000000001
10000010000000011111111111101
111100111K0000010000000000101
10000111111111111111111111101
100K01qLLL0000000000000000001
11111111111111111111111111111