111111111111111111111111111111111111111
100000000000000000000000000000000000001
10s000000000000000000000000000000000001
100000<00000000000000000000000000000001
100000000000000000000000000000000000001
100000000000000000000000000000000000001
100000000000000000000000000000000000001
100000000000000000000000000000000000001
100000000000000000000000000000000000001
100000000000000000000000000000000000001
100000000000000000000000000000000000001
100000000000000000000000000000000000001
10000000000000000000000000000>000000q01
100000000000000000000000000000000000001
111111111111111111111111111111111111111