111111111111111111
1s000q00000K00001
10111110011111001
10101001000001001
1010101111101001
1010100000001001
1010101111101001
1010101000101001
10101010P0101001
1010000000001001
101111010L010111
1000000000000001
111111111111111111